1100000000000000000000000000110000000000
100000000000101111000000@000000001110000
1100011000000000000000011100001101100000
1100111100000110100000111110001100000000
1100000000000000000001111110001110111000
1100110000000010000001111110001100010000
1100111000000011000011110000001100000001
1111111111111111111111110111111111111111
1111111111110000000000000000001111111111
0111111110000111110000000100001111100111
0011111100110000000000000000001110000111
0001111000110000000000100000001110100111
0001111001110000000001100011101100000011
0000010000110000000001110011101110110111
0010000011110000000010000000011100000011
1111001111111110111111110011111111000111
1110000111000000000000000000001111111111
1100000011001011110000000000000111111110
1111000111000000000000000000000111111100
1100000111000110100000000000000001111000
1111001111000000000000000000000001111000
1100000111000010000000000001010000010000
1111000111000010000011111011000100000110
1100000011111111111111111111111111001111
1110000111111111111100000111110000000000
1110000011100111000000100000000000000000
1110000111000000000001111000000000000000
1100000011000000000000000000000000000000
1100110011000000000000000000000001111000
1110000111000000000000100011110011111110
11111111110001010X0000101000000111111110
1111111111111111111111111111111111111111
Mikkel Balslev
Old Level 8
4
4
4
AB_OLD9
2


0