0000000000111111111111111111110000000000
0000000000110011011111110001110010111100
0000011100000000000011000000110000000000
0010010100000000000011100101110001101000
011100000000000@000011000001110000000000
0000011100000011100011101001110000100000
0000010100000111110011000001110001100000
0111000000111111111111100101111111111110
0000000000000000001111111111111111111111
0000000000000000000100000000000101111110
0000001110000010001111000000110001111100
0111001010000111101111111111110001101000
0000000000000000001111111111110001000000
0111000000000001101111101111110011111000
0000001110000011101111000000110111111100
0000000000111111111111000000111111111111
0000000000110000000011111111111111111111
0000000000100111000000000000001110010111
0011100000110010000011000000111100000011
0000101110110000000011101111111110010111
0000001010110000000011111111111110000011
0000000000110010100011001100101110010111
0100000100110011100001000000001110000111
1111000111111111111111000000111111100111
1000000001111111111111100011100111000000
1111000111001011001101000000000111001110
1111001111000000000000000001010000001010
0000000000000000000000000000000000000000
00101000000001110000000111000000000X0000
0111111110000011000000011100000000111000
1111111111000000000000000000000001111100
1111111111111111111111111111111111111111
Mikkel Balslev
Old Level 4
4
4
4
AB_OLD5
2


0