0000000000000000000011111111110000000000
0011111000011100001011111111100000000000
0000000000000000111100011100000001001100
000000000000000000000000000000000100@100
0000000000000000000000000000000001111110
0011111100001000000000101000000001111110
0000000100101000101000101000000000011111
1111110111111111111111111111111111111111
0000000000000000000000000000000000000000
0000000000000000000000000000000000010000
0000000000000111100000000000000000000000
0000100000000000000000000000000000000000
0001110000000111100001111111000110001110
0001111100000111100001111111100111001110
0011111100001111110111111111111100000011
1111111111111111111111111111111111001111
1111111111111111111110000000000000000000
1110010111000000000100000000001000000000
1100000111110000001111000010000000001110
1110010111111010001111001111000000000000
1110000111111111111111000000000000000000
1110010111111000101111000000000000000010
1100000011000000000110000000000000001010
1110011111110000001111110001111100111111
0000000011110000000000000000000000000000
0011100000000000000001111001000000000000
0001100011110001000001111001000000000000
0000000011110011110001111011000111111100
00000001111100000000000000010X0100000000
0000000111111101000001111111111100000001
0001010111111101000000111111101000111111
1111111111111111111111111111111111111111
Mikkel Balslev
Old Level 0
4
4
4
AB_OLD1
2
WELCOME

0