0000000011110000000000000000000000000000
0011100000000011100000000000000011100000
0010000011110011000000011001000001000000
000000001111000000000001@001000000000000
0000000011110000000000011111100000000000
0000000011110001010000011111100001011100
0000000011110001010000000111110000000110
1111100111111111111111111111111111110111
1111111111111111111100000000000000000000
1111111110011111111000000000000000000000
0011111110001101111000000000000000000000
0011111100000000000000000000000000000000
0001111000000000000000011111000100010000
0000110000000111100000111111001110010100
0100000000000000000011111111111111111111
1111001111111111111111111111111111111111
0000000000010000001000000000001111111101
0000011111000000000000101111000001110000
0110000000000000000000000000001101111011
1110000000000000000000011010001100111011
0000011100000000000000000000001101111011
0000001100000000000000001000001101111011
0000000000000000000000001010000000000000
1101111111111111111111111111111111101111
0000000000101101001000000000000000000011
0000000000000000000001111001000000000000
0000000000000000000001111001000001110011
0000000000011111111001111011000000000011
00011111000000000010000000010X0000000011
0111111100011111001101111111110000000011
1111111110000000000100111111110000000011
1111111111111111111111111111111111011111
Mikkel Balslev
Old Level 3
4
4
4
NONE
2


0