1111111111000000011111001000001111111111
1101010000011100000000000000001000011110
0000000000000100000000000000000000000000
0000000000000000000001111111000000000000
00000000000000000000010000000000000@0000
0000000000000010110011001111100000111000
0000000000001111110010000000000001111100
1110000011111111111111111111111111111111
0000000000111000010111111111100000000000
0000000000000000000000010100000000011111
0000000000000000000000000000000001000000
0000000000000000000000000000000111100000
0000000000000000000000000000000111000000
0000000000001000010000000010000000000010
0000101000001010111000001010000000001111
1111111111111111111111111111110000000000
1100000000000000000011111111111000000001
0000001000001011110010111111111110000111
1100000000000000000000000001111111000111
1100000000000110100000000000110000000000
1100000000001110000000000000000011111000
1100010000000000000010000000001111111111
1101010000000000000000000000011111111111
1111111111111111111111000000111111111111
1111111111111111111100000000001111111111
0000111000000000000000000000000101011110
1101111001110000001100000000000000000000
1100111011110010011100000000000000000000
1101111001111111111110000000000000000000
1101001011111000001100001000000000000000
0000000000110000000100001100000001110X00
1111011111000000111111111111111111111111
Mikkel Balslev
Old Level 1
4
4
4
AB_OLD2
2


0