1111111111000000000011111111111011111101
0000000000001011110000001000110001111000
1100000011000000000000000000001101111011
1111110011000110100000000000001101111011
1111111111000000000000000000001101111011
1101001011000000000000010011001101111011
0000000000000101000000010@11000000000000
1100000011111111111100011111001111101111
0000000000111111111100000000001100000000
0000000000011111111100000000000001110000
0010001110011111111100000000001101000000
0111100000111111111101111111001100000000
0000000000011111111001000000001100000000
0000001111000011100011000101001100000100
0000000000000000000010000101001100011100
1001111111111111111111111111111111111111
0000000000000000000011111111111111111111
0000000000011111111001111111111110110111
0000000000001111110001111111001100000011
1110000000000000000000011111001110000111
0110010000011100000000011110001110000011
0000010100000100110000000100001110010111
1111111111000000111101100001101110000011
1111111111111111111111110011111110111111
0000000011000000000000000000001111111111
0011111000001011110000100011100111111000
0000000011000000000000100111100001111100
0000000011000110100000110111110000110000
00000000110000000000X0110000000001000000
0000000011000010000011111111100001111100
0010100011000011000001111111100011111000
1111111111111111111111111111111111111111
Mikkel Balslev
Old Level 9
4
4
4
AB_OLD0
2


0