1111111111111111111111111111110000000000
0011111000000100011000011111000010111100
0001111100000000000000111111000000000000
0001011000000000000000010010000001101000
0000001000000000000000011110000000000000
0001111000000110110000011111000000010000
010111110000011@010001011111100000111000
1111111111100111111011111111111111111111
0000000000000000000011111111111111111111
0000000000000000000011110011110001111010
0000010000000000000011000000110001111100
0001111000111111110011101101110001000000
0000000000000000100011100000110000110000
0010010100000000000011100001110011111100
0010000100111111111111000001110101111000
1111001111111111111111111101111111111111
0000000000111111111111111111110000000000
0111111110000000000011011110111111100000
0011111100111111111000000000000000001110
0000000000000000000000000000000000000000
0000000000000000000000000000000000011100
0101000101111100101000100000000000010100
0101001100000000111000111000000000000000
1111111111111111111111111111111100111111
1100000000111111111100000000110000000000
1001111100111011111100111000000010011110
1100000000110000001100101000110010011110
1100000000111011011100000000110011011110
110011100011100001110000000111X011000000
1100000000111011011100010000111111111110
1100000000110000011100011100110111111110
1111111111111111011111111111111111111111
Mikkel Balslev
Old Level 5
4
4
4
AB_OLD6
2


0