0000000000000000000000000000000000000000
0111000@00000011000000000111111001111101
0000110000100000011110110000100010011111
0000011111000111000001111110001001100000
0111100000000001111000000011100111011000
0111111000000010001110000000111000000111
0000001110111100000000001110000110001001
0110000001100111011100000011100001110010
0001111000010000000111111100001110011101
0100011111100010000000000011001000000011
0111100000000000000000000000110000111000
0000111000000001011111111111001100100110
0000000110000010000110000001110011010011
0100110000000001100000000010001100110110
0111000000000111001110000011100011001011
0000110011001010000000000000011000000010
0110001100000000001100000000000000011101
0000110011011101000011111111111001011111
0000001100100000111100001111111111100000
0100110000001000001011000000000001101000
0111001100000111110000000000000000000111
0000000001111001011101001111100111100101
0100000000011110000001111111111001111100
0011111110100000001000000000000000000110
0100010111011000010001100000000001100000
0000000000110011111100111111111100111110
0101111000000000000011000100000011001111
0100111111110011000000110000000000110000
0101000011111110111111001110111111001100
0000110000100011001111100011111011110011
0100101110000000010000011000010000001100
0111110011100111001100001111000001000011
Mikkel Balslev
Generated Level
4
4
4
NONE
2


0
