0000000000000000000000000000000000000000
0@0I000000000000000000000000000000000000
1111101010010010000000000101100001010100
1100001000001001000001000010010010010100
0001000010000110100100000000011001000000
1111010000000001101011001000000000000111
1100001010001000000001000000000000001000
1010100100000101101010000000001000000100
0000000000101001010010001100100000000010
1100010101000010000000000000011010000100
0100000010101001000000010001000110000100
1111111000000000000100000001111010100100
1110001010110101100000110100010000100000
1100010001000000010110010011000000000000
0000001010000011001110100000000000000000
0100000100000000100100001000001100110010
1110010000001010000010000000110000001000
1100010010000000000001000001000100000010
1111000000000100100001000000000000000000
0100001100000100000000100100100101010001
1110010110001000100010001010100011000100
0001100100001000111001000100110101000000
1111000000000000001100001000001000000001
0110000110000000010000000100000000000110
1000001000000000001001001100001010111110
0000001000111100000000010101001101010000
0100000000001100010101100100000111000011
1111000000000110000011000000000000000000
1100000100000001100100001000001010001000
1100000100000000100000001111100010000000
001110111100010101000010100100100001X001
1111101111111001101111011111010111011101
Mikkel Balslev
Generated Level
4
4
4
NONE
2


1
HELLO WORLD!
0