1110000111111111111001000011111101111111
0@11111111100000011111111100000011110001
0000011001000100000010001110000001000010
0110100010001011110110000000111110000110
0001110111111001000110111001110001001100
0110001110110001011100100011100110011001
1011011000000111001011000111000100000011
1100110000000100010010010110001000110111
0000000011011000100100010100010001100110
1100000110110111101100110000111011000000
0011111100001111111001001001000000001101
1001111101000000110001101011011110011111
0010000001011000000010001111110001111000
1101000110110011011010100100000000110001
0110001100101111001111010011000011000010
1000001011000111110001111110001100101101
1011110010000000000000001110110110111001
1011100100011000001111100000101000110011
1001001000110010001001111001001101101110
1010000011100111110010010110111001001100
0000010101001110100100010010110110000001
1101001110010000001101100001000101110000
0011111000001000010001001010001101011111
0110000011110111110110100110100000000111
1100011101001101101110111001001111000000
1000111100000000001000010011111000011111
0101110001111101110000000111010101000011
0000000011100110100011001100011011100000
1100000010000000001101101000000000001101
0011101100110010110110000111100000111011
11000110100111111001101111111110111000X0
0011110000000000001101111000000110000100
Mikkel Balslev
Generated Level
4
4
4
NONE
2


0
