1100011001111111111000010011110001110000
0111001100000000001000001000001100011111
0001100111000000000000000010100110000001
1100110000000000000010000000110011111101
0110011110@00000000000110000011000010101
1011000001100111101110011101001111100110
1001101011000010100001001101100001010001
1101001001000001010111110100001100111000
0010000000001111010000011111100111000111
0100000111000001011111010000010100111001
1000000001111101000101011111000000001100
1000001000000011111010100001111011100110
1000010000000010010101001100010000111010
0100000000000011101110110111011111001111
0011000011100000100110000011010001100000
1000111000110100110011111001011100111100
1010001111010101011000001100111100000111
1011100001010100001111100011000111110101
1100011100010000100000111011100000010101
0110000100000000010011001100011111010110
0001111000000000000001000111001000011110
1100000000010001000001010001100111001011
0111110010010000000000000000110001101001
0000011001000000001001000000111111111100
1110001110110100000000000000000000001111
0011100001010011110111101000101011100000
1010111000111000000000100000000000001010
1011000100101111111110011110111100000001
1011100011100000000011110010000011000001
1000011000101111011000001011111000000X00
1111111110111111001111110100001111110111
1000000000000001000000010111100000011000
Mikkel Balslev
Generated Level
4
4
4
NONE
2


0
