1110000000100011111000111000001110001100
0011100100001000000110001111100000100111
1000010000000100100011000110000000010111
1111011000000000000000011010001110000000
0001010000000101000000000000@00010010110
1101010000000001100000100000101100011101
0101001101011000100000000100001010000011
0101101000001000000011000010000000001100
0100111010000001000000000101111110001011
0110000000110000011101110100000011101100
1011110000011101000100010111111001100011
1100000000100100110111000000100100111001
0111111000010010011000111110000010001110
0000000100001011000100000011100111100011
1011110111000001111011011000101000111010
1000011001000010000001001110011100011000
1111011100100000001101100010100111001011
0001000011000000000100111001110001101001
1101111001100010000110011100011001100110
0100001100100000010011000101001100111110
0111100110001100001011010101100011000001
0000111000100000011001000100100001111100
1110001110000001000101110010111100000000
0001100010000000000110001110000011111111
1000111001000001110000000001111000001000
0110001100001000010001101000000111010110
0011101000001011110000000001100111010011
1000100000000000000000000000010001001101
1110010000111111000000000000111101100101
001001000000X000101000000000000100110101
1001101111011110100111101111110111110011
1100100001000010110010100000010000010100
Mikkel Balslev
Generated Level
4
4
4
NONE
2


0
