1111111111000000000010111000100000000000
1111111111000000000000000000000011111000
1100000011000000000000000000000000000000
11101101110000011@0000111111100000000000
1100000011000111111000000000100000000000
1110010111000111111000001010110010111100
1100000111000001111100001110010000000100
1110100111111111111111111111111111110111
0000000011110000000011111111110000000000
0000000000000001000000011110000011101000
0000010011110000000011011110110000000000
0001111011110000000011001100110000000000
0000000011110000000011011110110000000000
0000100011110000000011010010110010100100
0010100011110000000000000000000010000100
1111111111111011011111111111111111001111
1100000000100000001011000000000000000000
0001111100000000000010000000000011111000
1100000000000010110011000100000000000000
1100000000000000000011001111000000000000
1100000000000001010011000000000000000000
1100000000000000000011000000000000000000
1101010000000110000011000000000010000100
1111111111111111111111100101111111001111
1111101110000000000011111111111100000001
0000000110000000110011111111111110001111
0000000000011101110011111111111110001111
0000000000000000000001111111110000000000
0000000000000011110001111111100000111000
0000000000000000000000100010001111111111
000X111000111111111100000000001111111111
1111111111111111111111111111111111111111
Mikkel Balslev
Old Level 6
4
4
4
AB_OLD7
2


0