1000000100000000100011000000000000110000
1111110011001110011111100001100010010001
001001010000000000000011000000000@011101
1011001000000000000000001100001001000100
1001100110000001000000000000001101110110
1100100000000000000000000101110101010011
0110011100000111111110000001010011011001
0010000110011000000000100000011110100101
1101110100001100110110011100001010110111
0100010100100011000001000000001110010001
0111001000000000111101111000000011001100
0000010100000100000110001100111101100011
1010101011100001110011100100001100111100
1001001000110000001000111011100110001011
1000101000001000011110001000010011110110
0110100110000000001010101110011000010011
0011010011110011000000100010101111011101
1001011001011000110000111010110001000111
0101001101000110001000001000011100110000
0101100010110011111000000111000110011011
1010110000011000100110000001100011001100
1010101110001010110000000000111001100011
1001100001100000001100000000001100110000
1010111010111100000000000000000010011111
0101010110010000001010110000000011000010
0011010011101000000000000111001001111101
0011011100100000111111000001101100000111
1001100110110000100100010000100111110100
1110111110011101011010000000011000010111
0010000011000010001010000000101111001000
1011111001111101111001X01110110011110111
1101001000001010001100100000001000000000
Mikkel Balslev
Generated Level
4
4
4
NONE
2


0
