1100000100000011100000000100010001110000
0111110111111100111111111111011100011011
0001110011000110000100000101001101001110
11100110010000111111110100011000@0100001
0101101000001000010000111100011010000100
1000101110000100101100000111100110000000
0111100000000000110100000000111111100111
1001101000010100101000000000000000000001
1100101100000000000000000000101011000001
0011000011001000000000111100010001000101
0001110001100011000000010011101100010000
1101011101110000100000011001110010100001
0110000100001110110000001110111000110000
0101010111110011010000000010001100000000
1010111000011011010100001011100011100000
1100001111011001010010000000010011000011
1011100001001110011001000000101001000000
0001011101100001000110000000101110000011
1111000100011101110010100000100000000000
0101010100000100011010000000011000000011
1000010101110111011101100000001000000000
1011010100001010000110010000000000000000
1000110111011001110010000000010100000001
1110000000101001011000000110001000011001
1010101010000110111100011000000000000100
1000000010100100000000001100111110101111
1010111010011011110000100110001011010000
0101000111001000010000110011000000110100
0101111001111100000010001001111110010011
0100X00100000000001011011000000011101000
0111100000101000010111100111111000101111
0000110000000000010101010000000110110001
Mikkel Balslev
Generated Level
4
4
4
NONE
2


0
