1111111111000000001111111111110000001110
0000000000000111000011100111110000001000
1100000011000110001111100000110111100000
1110111011000000001111100001110000000000
1111111111000000001111000001110000000000
1110101011000000001111100101110001000100
11000000110000000011111000011100010@0100
1100000011111101111111100011111001111100
0000000011111111111100000000000000000000
0011100000000111110000000000000000000000
0000000011000111110000000100000000000000
0000000011000100000000011110000000000000
0000000011000111100000000000000000000000
0000000011000111110000101100000000001000
0000000011010111110000100001000010101010
1110100111111111111111110011111111111111
1111111111111111111100000000001111111111
0000111111000000000000000000001111000111
0000000111111111111000000000001110000111
0000000111000000000000000110001110000111
0000000000000000000000001111001110000111
1000000000001100000100011111001110000111
0000000001011110011100111111001110000011
1110000111111111111111111111111111001111
0000000000111111111100000000000000000000
0000000000111111111000000000000000000110
0000000000010101110000011110000000001110
0000001110000000000000000000000000000000
00000001000000000000000111100000000X0000
0111100000001111000000011110000000011000
1111111111000000000000111111000000010000
1111111111111111111111111111111111111111
Mikkel Balslev
Old Level 2
4
4
4
AB_OLD3
2


0