0111000000000000001111111111111111111111
0100001010000000000000000000000000000000
0000001110000110001111000000111100000011
0000000000001110001111001111111100100111
0000000000000000011111111111111111111111
0001001100000010001111110110111110111111
000100@100001010001100000000010000000011
0001111100111111111111000000111100000011
0000000000000000000000000000110000000011
0111000000001011110000011100000000000000
0011001010000000000000001100110001110011
0000001110000110100000000000110000000011
0000001110000000000000000001110000000111
0000000100000010100000111100110000100011
0000000000000011100000000000110000101011
1101111111111111111111111111111111111111
0000000000111111111100000000001111111111
0000000000011111111100110000101100111111
0001110000011111111101111011110000001111
0001100000011111111000000111000000000011
0000000000011111111000000110000000000000
0001111100010100010000000000000000000000
0011111100000000000011111111110000000011
1111111111111111111111111111111100000111
1100000000000000000011111111110000000000
1000000000011100010000000000000000000000
1101110000011110010011111111100000000000
1101110000111110110000000000000000000000
1100000000000000110X00000000000111100000
1100010000011111111100100000100000011111
1100011100011111111001100011111111111111
1111111111111111111111111111111111111111
Mikkel Balslev
Old Level 7
4
4
4
AB_OLD8
2


0