1100000011000000111110000011000010000001
1100100000101110000010011001111011111100
0010000000000000010010001100001000000011
101100010000@000000000100111100111111000
1100000000001100000010010000001100001111
0000000011100000000000000101110011110001
0000101100111100111010000000001100011110
1100000110000011001011000000000111000011
0111100010111001101001000000110000011001
0000010010000000101110011110001111101101
1011000001110110100011000011101000010100
1001000001101010110011111000001110010101
1100001100111000011100000111100001010111
0110000010001011001011010000011101001001
0100100001000001110001011110000110011111
0110000000011100011100000001100011100000
0010001100000001010111111100111000101100
1010100111110001010000100110001110000111
1010100000000011011100110011000010111001
1010111111101000100111011001111001010101
1010100001000000010000001100001101100010
1010011100111100001001100110100100010110
1010000100000000000000100000010111001011
1001110110110001110001000000010001100011
1100010010011000110000100000011110101000
1111011011000110011100000001000010100101
0001001001110011010110100001011000100010
1101101100011001010000000101101010011011
0100100011111101011000110100111111001001
011001100000011000000X001010000001101100
0011011111110010101111101011111100100111
1001100000010000110000001100000110010000
Mikkel Balslev
Generated Level
4
4
4
NONE
2


0
