0111000100111111100111110000000000100111
0001110110000000010000001100111111110001
1100010000101011001111000111010100011100
0111010000000000000000110001010011000011
000000010001100000010100@000011001110000
1110100000000100000000001001001100001011
0001100000000011111100111001000110100000
1000010000000000110101000101110100101110
0111001101001110010111100000111010100011
0001100110000011000001111110001010011000
1100010011000000001110000001101011000111
0111111000101000000000010010101001110100
0100001100010101110000000111100100010111
0111100111111111001101000001111011010001
0000100001010111100000100000001001001100
1110111101011000101000000011100110100111
0010000000000110100101001000110010111001
1011111101100010111100001110011011001100
1000000010011010010100000001101001110101
1011100011001000010110000100100101010000
1000111001100010110000000110010110000110
1110001100110100111100001011011000110011
0011100110011000000100001001001110110001
1000110011000000001010000101100011010100
1110011001110000001000000000011010110011
0011101100111100000001100011000101011000
1000101100010111101000010000110111100111
1010000111010000101111010000010000000000
0011111001001110110001000010000000000001
1100000001000010011100000000000000000001
011111110011101110010X011101110101111101
0000000010001000110001000100010100000100
Mikkel Balslev
Generated Level
4
4
4
NONE
2


0
