0000000000000000111100100011000000010011
0001101111111100@00000111001110111011000
0000000000000111111110001101110001001110
0110100010000001100001000100011101100011
0000000001000100011101110111000100101000
1110000101000000000010010011110110000100
0000000110110001000000011100010010100111
1011100011011000000000000000011001010001
1001111001000111000000000001000101010101
1100001100110001001110000000110101010100
0111100010000000000000000000010101011111
0100111011111110010100000001110101101000
0010001100010010010011100000011100101111
0001111111011111011100011000010000010000
1100000001000100100111000000001111011111
0111111110000000000000100010000001000000
0000000000000000011000000000001001101110
1011101111000000000000000000000010010011
1000100000110000000000000010000011111001
1110111010000000000111001000000001101001
0010001111101000010010111010000010101100
1001101000100000010101100111000000000111
1100101011111000001010100000111111110000
0110110100000000010101111111011000011110
0010001011111000001010000101000111000011
1011010000000100010111010101111000011001
1000101110000000000000010100000111000001
1110100000000010000000001011100001001101
0010100000111001001000000000011111110101
1000000000001100101011001000000000100011
10X0011111100110111011100111111110111101
0010000000110010000100010001000010000110
Mikkel Balslev
Generated Level
4
4
4
NONE
2


0
