1100000110000000111000111100011111000100
0111110000101110000110000111100001110011
000000100@000000100011100000010100011001
1111000001000000000000111010001111001110
0000000000001100000000000000000001100010
1100001100000000000000000000111000111011
0000000011111100100000000000001110000100
0000110000100111001111111000100011010111
0000000010010001100000000000011000110001
0111100010010100001111111100000010011110
1010011001010011100000000011110011100011
1011101100111000111111110010100000111001
1000100110001010000000111010001100001101
1110110011110000001010000001000000000110
0010101000000000000001110100001011110011
1101001011000011110000000000000001111000
0110101000110000000011000001101101000111
0100001110010000100000110000100101110001
1010100001111000001000011110011010011100
1001101110000111000100000000011001000110
1100000110110001000000011010000000110011
0111011000010100110100001001100010011001
0001001111110110001011111010110000001101
1101100100010011011100001110010000011010
0100110111111100100111010011001000000001
0110101000100010110000101001110111011000
0001010100110010111101011100111000001101
1010101011001000000011000111001100010000
0101000101101110110001110001100000000001
000110110011001000100001110011100X000000
0100010010011111100111010111000101111011
0110011001000000000001010001100010001000
Mikkel Balslev
Generated Level
4
4
4
NONE
2


0
