1000111100011111100111101000110000010011
111000011100000011000@000110011111001000
0011010100001110011111000000000001100010
1001010000000001010001011000111100111111
1101010100001000011100100000000100000000
0101011000000100100100010110000001110100
0100100111100000000010011000000000000010
0101111001000000000001011101000000111010
1000011100100000000001100111100000001101
0101100110001001000000000000000001100100
0001110011100001010000001010000000010011
0110001000000001010010000000000111001001
1011000110000101010001110110100101001100
1010110000000001001100010001110100100110
1010011000010001111100011101010110010011
1011001100000100000111000110001011010001
1001100010000011001001110101011000011000
1100110001110001010000010000001111011111
0110011100011000001011001011100001000000
0011000111001110000000111000111100111111
1001111001100000100001101111000111000001
1100001110110010000000100101110010111100
1010010010011100000101110100011010000011
0000001011000000000000010111000010111001
1001000000110000000001010001101000001110
1000000000010000000000001100100011100010
1100000010000000010000000110100000011011
0000000000000000100000000010000111001001
1000001100000000010000001010100001100111
1100X00011111010000000000000000000110000
1001111010001101000000000100000010011111
0100001101100000000000000000000011000000
Mikkel Balslev
Generated Level
4
4
4
NONE
2


0
