1100010001111000000011111001100000000111
0111001100000001011000000100011111110000
0001100111000100101111000010000010010111
110010000000000@000001111001111001010000
0111000000001101011100001100001000011110
0001000000000100000011100011110101110001
1101111111110001010000011110010000001101
0100000000110011000010001001010111100110
1011111110011000100010010100000000111011
1000000011101101000000000111101011001011
1011101100100111111110000100011101101000
1000100110110000000001100000000100101010
1110110011011100110010110000110010101010
0011001101000000000010011100011011011011
1001100101111100111000100000101010101101
1100100110000000000000010000100100100100
0100101011100001100100000000110010010111
0000000100000011110011111000010101011011
1001000010000000011100000001010101101001
1000000000000000000110001000100100101110
1010000000000000110011101110111110100011
0101100100000000011000110011000010111001
0100100000001100001110011000111001001100
0010000000000000000011111100011100110011
1001000000010000011011000111000101011001
1100111100011010000001111000110000001100
0111000000001011001000000100001101100111
0001100100101000000000010011100000010010
1100000000001111110000011000101011110101
0101111000010000001100000000010100010100
010000111001111010001100X010101111010111
0111100001000010011000011000000001010000
Mikkel Balslev
Generated Level
4
4
4
NONE
2


0
